##################################################
#  P     O                                       #
#####   ####                                     #
#          #                                     #
#######                                          #
#  O ##    #######################################
#    ##    #
#          #
#       XX #
#       #  #
############