#####
# OO#
#X X#
#P  #
#####
