#### #######
#        O #
    P       
#          #
#######    #
#  O ##    #
#    ##    #
#          #
#       XX #
#       #  #
########## #